{
  "version": 1,
  "notes": "",
  "documentation": "\"This file is a QMK Configurator export. You can import this at <https://config.qmk.fm>. It can also be used directly with QMK's source code.\n\nTo setup your QMK environment check out the tutorial: <https://docs.qmk.fm/#/newbs>\n\nYou can convert this file to a keymap.c using this command: `qmk json2c {keymap}`\n\nYou can compile this keymap using this command: `qmk compile {keymap}`\"\n",
  "keyboard": "handwired/dactyl_manuform/4x6",
  "keymap": "handwired_dactyl_manuform_4x6_layout_mine",
  "layout": "LAYOUT",
  "layers": [
    [
      "LT(2,KC_EQL)",
      "KC_Q",
      "KC_W",
      "KC_E",
      "KC_R",
      "KC_T",
      "KC_Y",
      "KC_U",
      "KC_I",
      "KC_O",
      "KC_P",
      "LT(2,KC_NUBS)",
      "LT(1,KC_MINS)",
      "LGUI_T(KC_A)",
      "LALT_T(KC_S)",
      "LCTL_T(KC_D)",
      "LSFT_T(KC_F)",
      "KC_G",
      "KC_H",
      "RSFT_T(KC_J)",
      "RCTL_T(KC_K)",
      "LALT_T(KC_L)",
      "RGUI_T(KC_SCLN)",
      "LT(1,KC_QUOT)",
      "KC_LSPO",
      "KC_Z",
      "KC_X",
      "KC_C",
      "KC_V",
      "KC_B",
      "KC_N",
      "KC_M",
      "KC_COMM",
      "KC_DOT",
      "KC_SLSH",
      "KC_RSPC",
      "KC_GRV",
      "KC_NUHS",
      "KC_LBRC",
      "KC_RBRC",
      "LT(2,KC_ESC)",
      "LT(5,KC_SPC)",
      "LT(1,KC_ENT)",
      "LT(4,KC_DEL)",
      "LT(2,KC_ESC)",
      "KC_BSPC",
      "LT(3,KC_TAB)",
      "LT(4,KC_DEL)",
      "KC_NO",
      "KC_NO",
      "KC_NO",
      "KC_NO"
    ],
    [
      "KC_TRNS",
      "KC_LBRC",
      "KC_7",
      "KC_8",
      "KC_9",
      "KC_RBRC",
      "KC_TRNS",
      "KC_TRNS",
      "KC_TRNS",
      "KC_TRNS",
      "KC_TRNS",
      "KC_TRNS",
      "KC_TRNS",
      "KC_EQL",
      "KC_4",
      "KC_5",
      "KC_6",
      "KC_GRV",
      "KC_TRNS",
      "KC_TRNS",
      "KC_TRNS",
      "KC_TRNS",
      "KC_TRNS",
      "KC_TRNS",
      "KC_TRNS",
      "KC_NUBS",
      "KC_1",
      "KC_2",
      "KC_3",
      "KC_NUHS",
      "KC_TRNS",
      "KC_TRNS",
      "KC_TRNS",
      "KC_TRNS",
      "KC_TRNS",
      "KC_TRNS",
      "KC_TRNS",
      "KC_TRNS",
      "KC_TRNS",
      "KC_TRNS",
      "KC_PCMM",
      "KC_0",
      "KC_TRNS",
      "KC_TRNS",
      "KC_PCMM",
      "KC_TRNS",
      "KC_TRNS",
      "KC_TRNS",
      "KC_TRNS",
      "KC_TRNS",
      "KC_TRNS",
      "KC_TRNS"
    ],
    [
      "KC_TRNS",
      "KC_PSCR",
      "KC_F7",
      "KC_F8",
      "KC_F9",
      "KC_F10",
      "KC_TRNS",
      "KC_TRNS",
      "KC_TRNS",
      "KC_TRNS",
      "KC_TRNS",
      "KC_TRNS",
      "LCA(KC_DEL)",
      "KC_SLCK",
      "KC_F4",
      "KC_F5",
      "KC_F6",
      "KC_F11",
      "KC_TRNS",
      "KC_TRNS",
      "KC_TRNS",
      "KC_TRNS",
      "KC_TRNS",
      "KC_TRNS",
      "KC_TRNS",
      "KC_PAUS",
      "KC_F1",
      "KC_F2",
      "KC_F3",
      "KC_F12",
      "KC_TRNS",
      "KC_TRNS",
      "KC_TRNS",
      "KC_TRNS",
      "KC_TRNS",
      "KC_TRNS",
      "KC_TRNS",
      "KC_TRNS",
      "KC_TRNS",
      "KC_TRNS",
      "KC_TRNS",
      "KC_TRNS",
      "KC_TRNS",
      "KC_TRNS",
      "KC_TRNS",
      "KC_TRNS",
      "KC_TRNS",
      "KC_TRNS",
      "KC_TRNS",
      "KC_TRNS",
      "KC_TRNS",
      "KC_TRNS"
    ],
    [
      "KC_TRNS",
      "KC_TRNS",
      "KC_TRNS",
      "KC_TRNS",
      "KC_TRNS",
      "KC_TRNS",
      "RCTL(KC_LEFT)",
      "KC_END",
      "KC_HOME",
      "RCTL(KC_RGHT)",
      "KC_TRNS",
      "KC_TRNS",
      "KC_TRNS",
      "KC_TRNS",
      "KC_TRNS",
      "KC_TRNS",
      "KC_TRNS",
      "KC_TRNS",
      "KC_LEFT",
      "KC_DOWN",
      "KC_UP",
      "KC_RGHT",
      "KC_TRNS",
      "KC_TRNS",
      "KC_TRNS",
      "KC_TRNS",
      "KC_TRNS",
      "KC_TRNS",
      "KC_TRNS",
      "KC_TRNS",
      "KC_HOME",
      "KC_PGDN",
      "KC_PGUP",
      "KC_END",
      "KC_TRNS",
      "KC_TRNS",
      "KC_TRNS",
      "KC_TRNS",
      "KC_TRNS",
      "KC_TRNS",
      "KC_TRNS",
      "KC_TRNS",
      "KC_TRNS",
      "KC_TRNS",
      "KC_TRNS",
      "KC_TRNS",
      "KC_TRNS",
      "KC_TRNS",
      "KC_TRNS",
      "KC_TRNS",
      "KC_TRNS",
      "KC_TRNS"
    ],
    [
      "KC_TRNS",
      "LSFT(KC_LBRC)",
      "LSFT(KC_7)",
      "LSFT(KC_8)",
      "LSFT(KC_9)",
      "LSFT(KC_RBRC)",
      "KC_TRNS",
      "KC_TRNS",
      "KC_TRNS",
      "KC_TRNS",
      "KC_TRNS",
      "KC_TRNS",
      "KC_TRNS",
      "LSFT(KC_EQL)",
      "LSFT(KC_4)",
      "LSFT(KC_5)",
      "LSFT(KC_6)",
      "LSFT(KC_GRV)",
      "KC_TRNS",
      "KC_TRNS",
      "KC_TRNS",
      "KC_TRNS",
      "KC_TRNS",
      "KC_TRNS",
      "KC_TRNS",
      "LSFT(KC_NUBS)",
      "LSFT(KC_1)",
      "LSFT(KC_2)",
      "LSFT(KC_3)",
      "LSFT(KC_NUHS)",
      "KC_TRNS",
      "KC_TRNS",
      "KC_TRNS",
      "KC_TRNS",
      "KC_TRNS",
      "KC_TRNS",
      "KC_TRNS",
      "KC_TRNS",
      "KC_TRNS",
      "KC_TRNS",
      "LSFT(KC_9)",
      "LSFT(KC_0)",
      "KC_TRNS",
      "KC_TRNS",
      "KC_TRNS",
      "KC_TRNS",
      "KC_TRNS",
      "KC_TRNS",
      "KC_TRNS",
      "KC_TRNS",
      "KC_TRNS",
      "KC_TRNS"
    ],
    [
      "KC_TRNS",
      "KC_TRNS",
      "KC_TRNS",
      "KC_TRNS",
      "KC_TRNS",
      "KC_TRNS",
      "KC_TRNS",
      "KC_WH_U",
      "KC_MS_U",
      "KC_WH_U",
      "KC_ACL2",
      "KC_TRNS",
      "KC_TRNS",
      "KC_TRNS",
      "KC_TRNS",
      "KC_TRNS",
      "KC_TRNS",
      "KC_TRNS",
      "KC_TRNS",
      "KC_MS_L",
      "KC_MS_D",
      "KC_MS_R",
      "KC_ACL1",
      "KC_TRNS",
      "KC_TRNS",
      "KC_TRNS",
      "KC_TRNS",
      "KC_TRNS",
      "KC_TRNS",
      "KC_TRNS",
      "KC_TRNS",
      "KC_WH_D",
      "KC_WH_D",
      "KC_WH_D",
      "KC_ACL0",
      "KC_TRNS",
      "KC_TRNS",
      "KC_TRNS",
      "KC_TRNS",
      "KC_TRNS",
      "KC_TRNS",
      "KC_TRNS",
      "KC_BTN1",
      "KC_BTN2",
      "KC_TRNS",
      "KC_TRNS",
      "KC_BTN2",
      "KC_BTN3",
      "KC_TRNS",
      "KC_TRNS",
      "KC_BTN4",
      "KC_BTN5"
    ]
  ],
  "author": ""
}